[
    [6,6,8,8,8,8,0,0,0,0,0,0,0,0,0,0,0,0,0,0,0,0,8,8,6,6],
    [6,6,8,8,8,8,0,0,0,0,0,0,0,0,0,0,0,0,0,0,0,0,8,8,6,6],
    [8,8,8,8,0,0,0,0,0,0,1,1,3,3,0,0,0,0,0,0,0,0,0,0,8,8],
    [8,8,8,8,0,0,0,0,1,1,1,1,1,1,1,1,1,1,0,0,0,0,0,0,8,8],
    [8,8,0,0,0,0,0,1,1,1,1,1,1,1,1,1,1,1,1,1,0,0,0,0,6,6],
    [8,8,0,0,0,0,0,1,1,1,1,1,1,1,1,1,1,1,1,1,1,1,0,0,0,0],
    [6,6,0,0,0,0,1,1,1,1,1,1,1,1,1,1,1,1,1,1,1,1,1,0,0,0],
    [0,0,0,0,0,0,1,1,1,1,1,1,1,1,1,1,1,1,1,1,1,1,1,0,0,0],
    [0,0,0,0,0,1,1,1,0,0,0,0,0,0,1,1,1,1,1,1,0,0,1,0,0,0],
    [0,0,0,0,0,1,0,0,0,0,0,0,0,0,0,0,1,1,1,1,0,0,1,0,0,0],
    [7,7,0,0,0,1,0,0,6,0,0,0,6,0,0,0,1,1,1,0,0,0,0,0,0,0],
    [7,7,0,0,0,1,0,0,6,0,0,0,6,0,0,0,1,1,1,0,0,0,0,0,0,0],
    [0,0,0,0,1,1,0,0,0,0,0,0,0,0,0,0,1,1,1,0,0,0,7,7,7,7],
    [0,0,0,0,1,1,0,0,1,1,1,1,0,0,0,0,1,1,1,0,0,0,7,7,7,7],
    [0,0,0,0,1,1,1,1,1,1,1,1,1,1,1,1,1,1,1,1,0,0,0,0,0,0],
    [0,0,0,0,1,1,1,1,1,1,1,1,1,1,1,1,1,1,1,1,0,0,0,0,0,0],
    [0,0,0,1,1,1,1,1,1,1,1,1,1,1,1,1,1,1,1,1,1,0,0,0,0,0],
    [0,0,0,1,1,1,1,1,1,1,1,1,1,1,1,1,1,1,1,1,1,0,0,0,0,0],
    [0,0,1,1,1,1,1,1,1,1,1,1,1,1,1,1,1,1,1,1,1,1,0,0,0,0],
    [0,0,0,0,0,0,1,1,1,1,1,1,1,1,1,1,1,1,0,0,0,0,0,0,0,0],
    [0,0,1,1,1,1,0,0,1,1,1,1,1,1,1,1,0,0,1,1,1,1,0,0,8,8],
    [0,0,1,1,1,1,1,1,0,0,1,1,1,1,0,0,1,1,1,1,1,1,0,0,8,8],
    [8,8,0,0,1,1,1,1,0,0,0,0,0,0,0,0,1,1,1,1,0,0,8,8,8,8],
    [8,8,0,0,0,0,0,0,0,0,1,1,1,1,0,0,0,0,0,0,0,0,8,8,8,8],
    [6,6,8,8,0,0,0,0,0,0,1,10,11,1,0,0,0,0,0,0,8,8,8,8,6,6],
    [6,6,8,8,0,0,0,0,0,0,1,12,13,1,0,0,0,0,0,0,8,8,8,8,6,6]
]